1 2 3 4 2 2 2 2 2 6 9 8 3 4 1 1 1
1 2 3 4 2 2 2 2 6 2 15 16 3 4 1 1 1
1 2 3 4 2 2 2 6 2 2 21 22 3 4 1 1 1
1 2 3 4 2 2 6 2 2 2 10 11 3 4 1 1 1
1 1 3 4 5 6 15 16 9 8 2 2 3 4 1 1 1
1 1 1 1 1 1 1 1 1 1 2 2 3 4 1 1 1
1 1 3 4 21 22 2 2 2 2 2 2 3 4 1 1 1
1 1 3 4 10 11 2 2 2 2 12 1 1 1 1 1 1
7 8 3 4 2 2 2 2 2 6 2 2 2 9 8 1 1 1
13 14 3 4 2 2 2 2 6 2 2 2 15 16 1 1 1
19 20 3 4 15 16 5 6 9 8 9 8 15 16 1 1 1
1 1 1 1 1 1 1 1 1 1 1 1 1 1 1 1 1
